1 1 1 1
1 T G 1
1 G H 1
1 M G 1
1 0 R 1
1 D F 1
1 1 1 1
