1 1 1 1 1 1 1
1 T 0 0 G 0 1
1 0 0 H 0 0 1
1 M 0 R 0 G 1
1 D M 0 0 R 1
1 D 0 R 0 F 1
1 1 1 1 1 1 1
