2   2    2     2     2    2     2     2     2     2     2      2
2   0    0     0     0    3    .5     3    .5     0     0      2
2   0    3    .5     0   .2     0    .5     0     3     0      2
2   0   .5     0     0    0     0     0     0    .5     0      2
2   0    0     0    .8    0     0     0     0     0     0      2
2   0    3    .2     0    4     0     0    .2     3     0      2
2   0    0     0     0    0    .8     0     0    .5     0      2
2   0    0     0     0   .2     0     0     0     0     0      2
2   0   .5     0     0    3    .5     0     0    .5     0      2
2   0    3    .5    .5    0     0     0    .5     3     0      2
2   0    0    .8     0    0     0     0     0     0     0      2
2   2    2     2     2    2     2     2     2     2     2      2
