2   2    2     2     2    2     2     2     2     2     2      2
2   3    0     0     0    0     0     0    .7     0     3      2
2   0   .2     0     0    0     0     .8    3     0    .5      2
2   1   .9     0     0    0     0     0    .4     0     0      2
2   0    3     1    .5    0    .9     0     0     0     0      2
2   1    0    .9     0    4     0     0     0    .4     3      2
2   0    0     0     0    .9    0     0     0     0    .3      2
2   0   .5     0     0    0     0     0    .9     0     0      2
2   3   .9     0     0    0     0    .8     3     0     0      2
2   0    0    .8     0   .9     0     0    .1     0     0      2
2   0    0     0     0    3     0     0     0     0     0      2
2   2    2     2     2    2     2     2     2     2     2      2
