1 1 1 1 1 1 1
1 W1 0 0 0 0 1
1 0 0 0 0 0 1
1 0 0 R1 0 0 1
1 0 0 0 0 0 1
1 W2 0 0 0 0 1
1 1 1 1 1 1 1
